lands.png
LLLLLLLLLLLLLLLLLLLLLLLLLLLLLLLLLLLLLLLLLLLLLLLLLLLLLLLLLLLLLLLLLLLLLLLLLLLLLLLLLLLLLLLLLLLLLLLLLLLLLLLLLLLLLLLLLLLLLLLL
LL                                                                                                                    LL
LL                                                                                                                    LL
LL                                                                                                                    LL
LL                                                                                                                    LL
LL                                                                                                                    LL
LL                                                                                                                    LL
LL                                                                                                                    LL
LL                                                                                                                    LL
LL                                                                                                                    LL
LL                                                                                                                    LL
LL                                                                                                                    LL
LL                                                                                                                    LL
LL                                                                                                                    LL
LL                                                                                                                    LL
LL                                                                                                                    LL
LL                                                                                                                    LL
LL                                                                                                                    LL
LL                                                                                                                    LL
LL                                                                                                                    LL
LL                                                                                                                    LL
LL                                                                                                                    LL
LL                                                                                                                    LL
LL                                                                                                                    LL
LL                                                                                                                    LL
LL                                                                                                                    LL
LL                                                                                                                    LL
LL                                                                                                                    LL
LL                                                                                                                    LL
LL                                                                                                                    LL
LL                                                                                                                    LL
LL                                                                                                                    LL
LL                                                                                                                    LL
LL                                                                                                                    LL
LL                                                                                                                    LL
LL                                                                                                                    LL
LL                    A                            A   A                                                              LL
LL                   RRR                          RRRRRRR                                                             LL
LL                                                                                                                    LL
LL                                                                                                                    LL
LL                                                   B  C                                                             LL
LL                           B  B  B            LLLLLLLLLL                                                            LL
LL            LL   LLLLLL  LLL  LL  LLL    LL   LLLLLLLLLL                                                            LL
LL            LL   LLLLLL  LLL  LL  LLL    LL                                                                         LL
LL        LL  LL   LLLLLLY LLLY LLY LLL    LL                                                                         LL
LL        LL  LL   LLLLLL  LLL  LL  LLL Y  LL    B     B                                                              LL
LLP  LLL CLL  LL   LLLLLLLLLLLLLLLLLLLLLLLLLL       Y   C                                                           E LL
LLLLLLLLLLLLLLLLLLLLLLLLLLLLLLLLLLLLLLLLLLLLLLLLLLLLLLLLLLLLLLLLLLLLLLLLLLLLLLLLLLLLLLLLLLLLLLLLLLLLLLLLLLLLLLLLLLLLLLLL
LLLLLLLLLLLLLLLLLLLLLLLLLLLLLLLLLLLLLLLLLLLLLLLLLLLLLLLLLLLLLLLLLLLLLLLLLLLLLLLLLLLLLLLLLLLLLLLLLLLLLLLLLLLLLLLLLLLLLLLL
LLLLLLLLLLLLLLLLLLLLLLLLLLLLLLLLLLLLLLLLLLLLLLLLLLLLLLLLLLLLLLLLLLLLLLLLLLLLLLLLLLLLLLLLLLLLLLLLLLLLLLLLLLLLLLLLLLLLLLLL
