LLLLLLLLLLLLLLLLLLLLLLLLLLLLLLLLLLLLLLLLLLLLLLLLLLLLLLL
L                                                     L
L        C                                            L
LLLLLLLLLLLLLL      B                                 L
L                 LLLLL                     E         L
L                      Y                   LLLL     LLL
L                      LLLL                           L
L                               A               LLLL  L
L                             RRRRRR      RRR         L
L                                 C                   L
L                         RR     LLLLLLLLLLL          L
L   RRR           R                        LLLLLL    LL
L                    RR                               L
L       L      LL         B                        LLLL
L P   LLL    LLLL        LL  LL                  LLLLLL
L    LLLL   LLLLLLL     LL     LL              LLLLLLLL
LLLLLLLLLLLLLLLLLLLLLLLLLLLLLLLLLLLLLLLLLLLLLLLLLLLLLLL
LLLLLLLLLLLLLLLLLLLLLLLLLLLLLLLLLLLLLLLLLLLLLLLLLLLLLLL
LLLLLLLLLLLLLLLLLLLLLLLLLLLLLLLLLLLLLLLLLLLLLLLLLLLLLLL