LLLLLLLLLLLLLLLLLLLLLLLLLLLLLLLLLLLLLLLLLLLLLLLLLLLLLLL
L                                                     L
L                                                     L
L                                                     L
L                 RRRRR                               L
L                                          LLLL     LLL
L   E                  LLLL                           L
LRRRRRRRRRRRRR                                  RRRR  L
L                             LLLLLL      SSR         L
L           P                                         L
L                         SS     LLLLLLLLL            L
LRRRRRRRR        SS                    RRRRR        RRL
L                  SS       LLLLL                     L
L          SSSS                              RRR      L
L                 RRRRR                               L
L                          LLLLLSSSSSSS           RRRRL
LLLLLLLLLLLLLLLLLLLLLLLLLLLLLLLLLLLLLLLLLLLLLLLLLLLLLLL
LLLLLLLLLLLLLLLLLLLLLLLLLLLLLLLLLLLLLLLLLLLLLLLLLLLLLLL
LLLLLLLLLLLLLLLLLLLLLLLLLLLLLLLLLLLLLLLLLLLLLLLLLLLLLLL