desert.png
SSSSSSSSSSSSSSSSSSSSSSSSSSSSSSSSSSSSSSSSSSSSSSSSSSSSSSS
S                                                     S
S                                                     S
S                                                     S
S                 SSSSS                               S
S                                          SSSS     SSS
S   E    B             SSSS                           S
SSSSSSSSSSSSSS                                  SSSS  S
S                             SSSSSS      SSS         S
S           P             C            C              S
S C  C                S   SS     SSSSSSSSS            S
SSSSSSSSS        SS           C        SSSSS        SSS
S                  SS       SSSSS                     S
S          SSSS   C                          SSS      S
S                 SSSSS                               S
S                          SSSSSSSSSSSS           SSSSS
SSSSSSSSSSSSSSSSSSSSSSSSSSSSSSSSSSSSSSSSSSSSSSSSSSSSSSS
SSSSSSSSSSSSSSSSSSSSSSSSSSSSSSSSSSSSSSSSSSSSSSSSSSSSSSS
SSSSSSSSSSSSSSSSSSSSSSSSSSSSSSSSSSSSSSSSSSSSSSSSSSSSSSS