LLLLLLLLLLLLLLLLLLLLLLLLLLLLLLLLLLLLLLLLLLLLLLLLLLLLLLL
L                                                     L
L        C                                            L
LRRRRRRRRRRRRR      B                                 L
L                 RRRRR                     E         L
L                      Y                   LLLL     LLL
L                      LLLL                           L
L                                               RRRR  L
L                             LLLLLL      SSR         L
L                                 C                   L
L                         SS     LLLLLLLLLLL          L
L   SRS           S                      SSSSSSSS    RL
L P                  SS                               L
L       L      LL         B                        LLLL
L     LLL    SLLL        LS  LL                  LLLLLL
L    LLLL   RRRLLLL     SL     LL              LLLLLLLL
LLLLLLLLLLLLLLLLLLLLLLLLLLLLLLLLLLLLLLLLLLLLLLLLLLLLLLL
LLLLLLLLLLLLLLLLLLLLLLLLLLLLLLLLLLLLLLLLLLLLLLLLLLLLLLL
LLLLLLLLLLLLLLLLLLLLLLLLLLLLLLLLLLLLLLLLLLLLLLLLLLLLLLL