LLLLLLLLLLLLLLLLLLLLLLLLLLLLLLLLLLLL
L                                  L
L                                  L
L                                  L
L                                  L
L                                  L
L                                  L
L                                  L
L                                  L
L    P                             L
L                         SS       L
L   SRS           S                L
L                    SS            L
L       L     LL                   L
L     LLL    SLLL        LS  LL    L
L    LLLL   RRRLLLL     SL     LL  L
LLLLLLLLLLLLLLLLLLLLLLLLLLLLLLLLLLLL
LLLLLLLLLLLLLLLLLLLLLLLLLLLLLLLLLLLL
LLLLLLLLLLLLLLLLLLLLLLLLLLLLLLLLLLLL