LLLLLLLLLLLLLLLLLLLLLLLLLLLLLLLLLLLLLLLLLLLLLLLLLLLLLLL
L                                                     L
L                                                     L
L                                                     L
L                    RRR           RRRR             E L
L             LLLL                          LLLL   LLLL
L                           RRRR                      L
L                  RRRR                               L
L                                                     L
L                        RRR                          L
L                     RRR                             L
L                  RRR                                L
L               RRR                                   L
L            RRR                            P         L
L         RRR                                         L
L    RRR                                              L
LLLLLLLLLLLLLLLLLLLLLLLLLLLLLLLLLLLLLLLLLLLLLLLLLLLLLLL
LLLLLLLLLLLLLLLLLLLLLLLLLLLLLLLLLLLLLLLLLLLLLLLLLLLLLLL
LLLLLLLLLLLLLLLLLLLLLLLLLLLLLLLLLLLLLLLLLLLLLLLLLLLLLLL