lands.jpg

      LL LL                         
     LLLLLLL                        
      LLLLL     LLL                 
       LLL     LL LL                
        L      L   LL               
                L   L               
   LLLLL LLL     LL   LLLLLLL       
L    L   L        LL     L          
L    L   LL        L     L         L
L    L   L     L E LL    L         L
L    L   LLL   LL   L       LLLLL  L
L               LLLLL      L     L L
L    LLL     LL  LL       L  L L  L
L         L               L       L 
L         L               L LLLLL L 
L P          LLL          L       L
L                   LL     LLLLLLL L
LLLLLLLLLLLLLLLLLLLLLLLLLL         L
LLLLLLLLLLLLLLLLLLLLLLLLLLLLLLLLLLLL
