tutorial.png
LLLLLLLLLLLLLLLLLLLLLLLLLLLLLLLLLLLLLLLLLLLLLLLLLLLLLLL
L                                                     L
L                                                     L
L                                                     L
L                                                     L
L                                                     L
L                                                     L
L                                                     L
L                                                     L
L                                                     L
L                                                     L
LLLL                                                  L
LLLLLLL         LLLLLLL           LLLLLLLLLLL         L
L         LL                                      LLLLL
L        LLLLL          LLLLLLLL               LLLLLLLL
L P                                       LLLLLLLLLLLLL
LLLLLLLLLLLLLLLLLLLLLLLLLLLLLLLLLLLLLLLLLLLLLLLLLLLLLLL
LLLLLLLLLLLLLLLLLLLLLLLLLLLLLLLLLLLLLLLLLLLLLLLLLLLLLLL
LLLLLLLLLLLLLLLLLLLLLLLLLLLLLLLLLLLLLLLLLLLLLLLLLLLLLLL